af = Afrikaans
ar = Arabic
az = Azerbaijani
eu = Basque
be = Belarusian
bs = Bosnian
pt_BR = Brazilian Portugese
br = Breton
bg = Bulgarian
ca = Catalan
zh_TW = Chinese
zh_CN = Chinese Simplified
hr = Croatian
cs = Czech
da = Danish
nl = Dutch
eo = Esperanto
et = Estonian
fa = Farsi
fo = Faroese
fi = Finnish
fr = French
gl = Galician
de = German
el = Greek
he = Hebrew
hu = Hungarian
is = Icelandic
id = Indonesian
ga = Irish Gaelic
it = Italian
ja = Japanese
ko = Korean
ku = Kurdish
lv = Latvian
lt = Lithuanian
mk = Macedonian
mt = Maltese
mi = Maori
se = Northern Sami
nso = Northern Sotho
nb = Norwegian Bokmaal
nn = Norwegian Nyorsk
oc = Occitan
pl = Polish
pt = Portugese
ro = Romanian
ru = Russian
sr = Serbian
sk = Slovak
sl = Slovenian
es = Spanish
ss = Swati
sv = Swedish
ta = Tamil
th = Thai
tr = Turkish
en_GB = UK English
uk = Ukranian
ven = Venda
vi = Vietnamese
wa = Walloon
cy = Welsh
xh = Xhosa
zu = Zulu
